あいにく	あいにく	unfortunately, Sorry, but....	n3
あちこち	あちこち	here and there	n3
あっ	あっ	Ah!, Oh!	n3
あらゆる	あらゆる	all, every	n3
ありがとう	ありがとう	(conj,exp,int) Thank you	n3
あるいは	あるいは	or, possibly	n3
あんなに	あんなに	to that extent, to that degree	n3
あんまり	あんまり	not very, not much, remainder, rest	n3
いえ	いえ	same as いいえ in spoken	n3
いけない	いけない	must not do, bad, wrong, not good	n3
いずれ	いずれ	which, either, one	n3
いたずら	いたずら	tease, prank, trick, practical joke	n3
いただきます	いただきます	expression of gratitude before meals	n3
いつか	いつか	sometime, someday, one day	n3
いつでも	いつでも	(at) any time, always, at all times, never (neg)	n3
いつまでも	いつまでも	forever, for good, eternally, as long as one likes, indefinitely	n3
いつも	いつも	always, usually, every time, never (with neg. verb)	n3
いらいら	いらいら	getting nervous, irritation	n3
いらっしゃい	いらっしゃい	welcome	n3
いわゆる	いわゆる	the so-called, so to speak	n3
うがい	うがい	gargle, rinse mouth	n3
うなる	うなる	to groan, to moan	n3
うまい	うまい	be good at, delicious (spoken)	n3
お	じき	earnestly,immediately,exactly	n3
おしゃべり	おしゃべり	chattering, talk, idle talk	n3
おそらく	おそらく	perhaps	n3
おまえ	おまえ	(fam) you (sing)	n3
おめでとう	おめでとう	Congratulations!, an auspicious occasion!	n3
およそ	およそ	about, roughly, as a rule, approximately	n3
お互い	おたがい	mutual, reciprocal, each other	n3
お昼	おひる	lunch, noon	n3
お腹	おなか	stomach, tummy	n3
かなり	かなり	considerably,fairly,quite	n3
かもしれない	かもしれない	may,might,perhaps,may be,possibly	n3
かわいそう	かわいそう	poor,pitiable,pathetic	n3
かわいらしい	かわいらしい	lovely,sweet	n3
がっかり	がっかり	feel disappointed,be dejected,lose heart	n3
きちんと	きちんと	precisely,accurately	n3
きつい	きつい	tight,close,intense	n3
ぐっすり	ぐっすり	sound asleep,fast asleep	n3
けち	けち	stinginess,miser,miserliness	n3
ここ	ここ	here	n3
この	この	this	n3
これら	これら	these	n3
こんなに	こんなに	so,like this,in this way	n3
こんにちは	こんにちは	hello,good day (daytime greeting, id)	n3
ごめんなさい	ごめんなさい	I beg your pardon,excuse me	n3
さ	きょか	permission,approval	n3
さっぱり	さっぱり	feeling refreshed,feeling relieved,neat,trimmed	n3
さて	さて	well,now,then	n3
ざっと	ざっと	roughly,in round numbers	n3
しかも	しかも	moreover,furthermore,nevertheless,and yet	n3
しきりに	しきりに	frequently,repeatedly,incessantly,eagerly	n3
したがって	したがって	therefore,consequently,in accordance with	n3
しばしば	しばしば	often,again and again,frequently	n3
しまう	しまう	to finish, to close, put an end	n3
しまった	しまった	Damn it!	n3
しゃべる	しゃべる	to talk,to chat,to chatter	n3
じっと	じっと	fixedly,firmly,patiently,quietly	n3
すごい	すごい	terrible,dreadful,terrific,amazing,great	n3
すてき	すてき	lovely,dreamy,beautiful,great	n3
すなわち	すなわち	that is,namely,i.e.	n3
すみません	すみません	sorry,excuse me	n3
すると	すると	thereupon,hereupon	n3
ずっと	ずっと	consecutively,throughout,a lot	n3
そう	そう	so	n3
そこで	そこで	so (conj),accordingly,now,then,thereupon	n3
そして	そして	and	n3
そっくり	そっくり	all,altogether,entirely,be just like,the splitting image of	n3
そっと	そっと	face of the earth	n3
その	その	the,that	n3
そのうち	そのうち	eventually,sooner or later,of the previously mentioned	n3
そのまま	そのまま	without change,as it is (i.e. now)	n3
それ	それ	it,that	n3
それぞれ	それぞれ	each,every,either,respectively,severally	n3
それでも	それでも	but (still),and yet,nevertheless,even so,notwithstanding	n3
それとも	それとも	or,or else	n3
ただ	ただ	free of charge,	n3
たっぷり	たっぷり	full,in plenty,ample	n3
たとえ	たとえ	simile,metaphor,allegory	n3
たびたび	たびたび	often,repeatedly,frequently	n3
たまらない	たまらない	intolerable, unbearable, unendurable	n3
だから	だから	so,therefore	n3
だが	だが	however	n3
だけど	だけど	however	n3
だって	だって	but,because,even,also,too	n3
ちゃんと	ちゃんと	perfectly,properly,exactly	n3
ちょうだい	ちょうだい	(1) please do for me (preceded byte),(2) reception,being given,get (spoken)	n3
つまり	つまり	in short,in brief,in other words	n3
できる	できる	to be able to,to be ready,to occur	n3
できれば	できれば	if at all possible	n3
ですから	ですから	therefore	n3
では	では	then, in that case,if so	n3
でも	でも	but,however	n3
ところが	ところが	however,while,even if	n3
ところで	ところで	by the way,even if,no matter what	n3
とにかく	とにかく	anyhow,at any rate,anyway,somehow or other,generally speaking,in any case	n3
とんでもない	とんでもない	unexpected,offensive,What a thing to say!,No way!	n3
どうしても	どうしても	by all means,at any cost,no matter what	n3
どこか	どこか	somewhere,anywhere	n3
どれ	どれ	which (of three or more)	n3
どんな	どんな	what,what kind of	n3
どんなに	どんなに	how,how much	n3
なお	なお	straight,mischief,ordinary,common	n3
なかなか	なかなか	very,considerably,easily	n3
なぜなら	なぜなら	because	n3
なにも	なにも	nothing	n3
にっこり	にっこり	smile sweetly,smile,grin	n3
のんびり	のんびり	carefree,at leisure	n3
はあ	はあ	Yes, Uh-huh, I see,	n3
はさみ	はさみ	scissors	n3
ばったり	ばったり	with a clash (thud),with a bang,plump,flop	n3
びっくり	びっくり	be surprised,be amazed,be frightened,astonishment	n3
ぴったり	ぴったり	exactly,neatly,sharp	n3
ふと	ふと	suddenly,casually,accidentally,incidentally,unexpectedly,unintentionally	n3
ほぼ	ほぼ	almost,roughly,approximately	n3
ぼんやり	ぼんやり	absent-minded,block-head,dim,faint,vague	n3
まあ	まあ	(female) you might say	n3
まさか	まさか	nonsense, that's impossible,	n3
まさに	まさに	correctly, surely	n3
ますます	ますます	increasingly,more and more	n3
まるで	まるで	quite,entirely,completely	n3
もしも	もしも	if	n3
やがて	やがて	before long,soon,at length	n3
やはり	やはり	also,as I thought,still,in spite of,absolutely,of course	n3
やや	やや	a little,partially,somewhat,a short time,a while	n3
ゆっくり / と	ゆっくり / と	slowly,at ease	n3
よい	よい	good,nice,pleasant,ok	n3
よると	よると	according to	n3
よろしく	よろしく	well,properly,suitably,best regards,please remember me	n3
わがまま	わがまま	selfishness, wilfulness, whim	n3
わざと	わざと	on purpose	n3
アイスクリーム	アイスクリーム	ice cream	n3
アイロン	アイロン	(electric) iron	n3
アウト	アウト	out	n3
アルバム	アルバム	album	n3
インク	インク	ink	n3
ウイスキー	ウイスキー	whisky	n3
エネルギー	エネルギー	(n) energy (de: Energie)	n3
エンジン	エンジン	engine	n3
オフィス	オフィス	office	n3
オーバー	オーバー	(1) overcoat,(2) over	n3
カー	カー	car	n3
カード	カード	card,curd	n3
キャプテン	キャプテン	captain	n3
キャンプ	キャンプ	camp	n3
キロ	キロ	(abbr) kilo-, kilogram, kilometre,	n3
キロ	キロ	(abbr) kilo-,kilogram,kilometre,10^3	n3
クラシック	クラシック	classic(s)	n3
クリスマス	クリスマス	Christmas	n3
クリーム	クリーム	cream	n3
グラス	グラス	(1) glass,(2) grass	n3
グランド	グランド	gland,grand,(electrical) ground	n3
グループ	グループ	group	n3
ケース	ケース	case	n3
ゲーム	ゲーム	game	n3
コピー	コピー	(1) a (photo)copy,(2) blurb on a book jacket	n3
コンピューター	コンピューター	computer	n3
コーチ	コーチ	coach	n3
コード	コード	code,cord,chord	n3
ゴール	ゴール	goal	n3
サイン	サイン	(1) autograph,(2) sign,(3) sine	n3
サービス	サービス	(1) service,support system,(2) goods or services without charge	n3
ジェット機	ジェットき	jet aeroplane	n3
ジュース	ジュース	juice,soft drink,deuce	n3
ジーンズ	ジーンズ	jeans	n3
スイッチ	スイッチ	switch	n3
スキー	スキー	skiing	n3
スケート	スケート	skate(s),skating	n3
スタイル	スタイル	style	n3
スタンド	スタンド	stand	n3
スター	スター	star	n3
スピーチ	スピーチ	speech	n3
スープ	スープ	(Western) soup	n3
セット	セット	set	n3
センター	センター	a center	n3
ソファー	ソファー	sofa,couch	n3
タイプライター	タイプライター	typewriter	n3
タオル	タオル	towel	n3
ダイヤ	ダイヤ	(1) diagram,(2) (railway) schedule,(3) diamond	n3
ダンス	ダンス	dance	n3
チャンス	チャンス	chance,opportunity	n3
チーズ	チーズ	cheese	n3
チーム	チーム	team	n3
テント	テント	tent	n3
デモ	デモ	(abbr) demo,demonstration	n3
デート	デート	date,go on a date	n3
トップ	トップ	top	n3
トラック	トラック	(1) truck,(2) (running) track	n3
トランプ	トランプ	playing cards (lit: trump)	n3
トン	トン	ton	n3
トンネル	トンネル	tunnel	n3
ドライブ	ドライブ	drive,trip by car,driving	n3
ドラマ	ドラマ	drama	n3
ドレス	ドレス	dress	n3
ノック	ノック	(1) knock,(2) fungo (baseball)	n3
ノー	ノー	no	n3
ハイキング	ハイキング	hiking	n3
ハンサム	ハンサム	handsome	n3
バイオリン	バイオリン	violin	n3
バッグ	バッグ	bag,	n3
バン	バン	bun,van (caravan),VAN (value-added network)	n3
パイプ	パイプ	(1) pipe,tube,(2) channels, official or otherwise	n3
パイロット	パイロット	pilot	n3
パス	パス	path,pass (in games)	n3
パスポート	パスポート	passport	n3
パーセント	パーセント	percent	n3
ビデオ	ビデオ	video	n3
ビール	ビール	beer	n3
ピクニック	ピクニック	picnic	n3
ピン	ピン	pin	n3
ブレーキ	ブレーキ	a brake	n3
プラス	プラス	plus	n3
プラン	プラン	plan	n3
プロ	プロ	professional	n3
ベルト	ベルト	Belt for western clothes	n3
ベンチ	ベンチ	bench	n3
ペンキ	ペンキ	(n) paint (nl: pek)	n3
ホーム	ホーム	(1) platform,(2) home	n3
ボーイ	ボーイ	boy	n3
ボート	ボート	rowing boat	n3
ボール	ボール	ball,bowl	n3
マイク	マイク	mike	n3
マスター	マスター	proprietor,manager,barowner,master (e.g. arts, science)	n3
ママ	ママ	Mama	n3
マーケット	マーケット	market	n3
ミス	ミス	miss (mistake, error, failure),Miss	n3
ミルク	ミルク	milk	n3
メモ	メモ	memorandum	n3
メンバー	メンバー	member	n3
ユーモア	ユーモア	humor	n3
ヨット	ヨット	yacht	n3
ヨーロッパ	ヨーロッパ	Europe	n3
ライター	ライター	lighter,rider,writer	n3
ラケット	ラケット	racket, paddle,	n3
レポート	レポート	report,paper	n3
ロケット	ロケット	locket,rocket	n3
ワイン	ワイン	wine	n3
一人一人	ひとりひとり	one by one,each,one at a time	n3
一体	いったい	(1) one object, one body,(2) what on earth?, really?,(3) generally	n3
一家	いっか	a house, a home, a family, a household	n3
一層	いっそう	much more, still more, all the more	n3
一度に	いちどに	all at once	n3
一方	いっぽう	(1) on the other hand,(2) meanwhile,(3) only, simple, in turn	n3
一時	いちじ	moment, time	n3
一生	いっしょう	whole life, a lifetime, all through life	n3
一番	いちばん	best, first, number one	n3
一瞬	いっしゅん	a moment, an instant	n3
一種	いっしゅ	a species, a kind, a variety	n3
一致	いっち	(1) coincidence, agreement,(2) conformity	n3
一般	いっぱん	general, liberal, universal, ordinary, average	n3
一言	ひとこと	single word	n3
七	しち / なな	seven	n3
七	なな	seven	n3
万一	まんいち	by any chance	n3
上	かみ	(1) first volume,(2) superior quality,(3) governmental	n3
上	じょう	(1) first volume,(2) superior quality,	n3
上京	じょうきょう	proceeding to the capital (Tokyo)	n3
上等	じょうとう	superiority,first class,very good	n3
上達	じょうたつ	improvement,advance,progress	n3
下	げ	under,below,beneath	n3
下	しも	under,below,beneath	n3
下さる	くださる	(hon) to give,to confer	n3
下す	おろす	to lower, to let go down	n3
下り	くだり	down-train (going away from Tokyo)	n3
不	ふ	un,non,negative prefix	n3
不利	ふり	disadvantage,handicap,unfavorable,drawback	n3
不可	ふか	wrong,bad,improper,unjustifiable,inadvisable	n3
不安	ふあん	anxiety,uneasiness,insecurity,suspense	n3
不平	ふへい	complaint,discontent,dissatisfaction	n3
不幸	ふこう	unhappiness,sorrow,misfortune,disaster,accident,death	n3
不思議	ふしぎ	mystery,curiosity	n3
不正	ふせい	injustice,unfairness	n3
不満	ふまん	dissatisfaction,displeasure,discontent,complaints,unhappiness	n3
不自由	ふじゆう	discomfort,disability,inconvenience,destitution	n3
不足	ふそく	insufficiency,shortage,deficiency,lack,dearth	n3
与える	あたえる	to give, to present, to award	n3
世の中	よのなか	society,the world,the times	n3
世紀	せいき	century,era	n3
世話	せわする	looking after,help,aid,assistance, to look after	n3
世間	せけん	world,society	n3
丘	おか	hill, height, knoll, rising ground	n3
両替	りょうがえ	change,money exchange	n3
中	ちゅう	inside,middle,among	n3
中古	ちゅうこ	(1) used,second-hand,old	n3
中央	ちゅうおう	centre,central,center,middle	n3
中学	ちゅうがく	middle school,junior high school	n3
中心	ちゅうしん	center,core,heart,pivot,emphasis,balance	n3
中止	ちゅうし	suspension, stoppage, discontinuance, interruption	n3
丸	まる	circle,full (month),perfection,purity,suffix for ship names	n3
丸い	まるい	round,circular,spherical	n3
主に	おもに	mainly, primarily	n3
主婦	しゅふ	housewife,	n3
主張	しゅちょう	claim,request,insistence,assertion	n3
主義	しゅぎ	doctrine,rule,principle	n3
主要	しゅよう	chief,main,principal,major	n3
乗せる	のせる	to take on board,to give a ride	n3
乗客	じょうきゃく	passenger	n3
九	きゅう / く	nine	n3
九	く	nine	n3
予報	よほう	forecast,prediction	n3
予期	よき	expectation,assume will happen,forecast	n3
予測	よそく	prediction,estimation	n3
予算	よさん	estimate,budget	n3
予防	よぼう	prevention,precaution,protection against	n3
事	こと	thing,matter,fact,circumstances	n3
事件	じけん	event,affair,incident	n3
事務	じむ	business,office work	n3
事実	じじつ	fact,truth,reality	n3
事情	じじょう	circumstances,consideration,conditions,situation,reasons	n3
事態	じたい	situation,present state of affairs	n3
二十（歳）	はたち	20 years old,	n3
互い	たがい	mutual,reciprocal	n3
交換	こうかん	exchange,interchange,reciprocity	n3
交際	こうさい	company,friendship,association,society,acquaintance	n3
人工	じんこう	artificial,manmade,human work,human skill,artificiality	n3
人気	にんき	popularity	n3
人物	じんぶつ	character,personality,person,man,personage,talented man	n3
人生	じんせい	(human) life (i.e. conception to death)	n3
人種	じんしゅ	race (of people)	n3
人込み	ひとごみ	crowd of people	n3
人間	にんげん	human being,man,person	n3
人類	じんるい	mankind,humanity	n3
今に	いまに	before long, even now	n3
今にも	いまにも	at any time, soon	n3
今回	こんかい	now,this time,lately	n3
今後	こんご	from now on,hereafter	n3
今日	こんにち	today,this day	n3
仏	ほとけ	Buddha,merciful person,Buddhist image,the dead	n3
他	た	other (esp. places and things)	n3
他人	たにん	another person,unrelated person,outsider,stranger	n3
他（外）	ほか	some, other place, the rest	n3
付き合い	つきあい	association,socializing,fellowship	n3
付ける	つける	to attach,to join,to add,to append	n3
代理	だいり	representation,agency,proxy,deputy,agent	n3
代表	だいひょう	representative,representation,delegation,type,example,model	n3
代金	だいきん	price,payment,cost,charge	n3
以前	いぜん	ago since, before, previous	n3
以来	いらい	since, henceforth	n3
仲	なか	relation,relationship	n3
仲間	なかま	company,fellow,colleague,associate	n3
任せる	まかせる	to entrust to another,to leave to	n3
企業	きぎょう	enterprise,undertaking	n3
休憩	きゅうけい	rest,break,recess,intermission	n3
休暇	きゅうか	holiday,day off,furlough	n3
会	かい	meeting, assembly, party, association, club	n3
会合	かいごう	meeting, assembly	n3
会員	かいいん	member, the membership	n3
会計	かいけい	account, finance, accountant	n3
伝統	でんとう	tradition,convention	n3
伸ばす	のばす	to lengthen,to stretch,to reach out,to grow (beard)	n3
伸びる	のびる	to stretch,to extend,to make progress,to grow (beard, body height)	n3
伺う	うかがう	(hon) to visit, to ask, to inquire	n3
似合う	にあう	to suit,to match,to become,to be like	n3
位	くらい	grade,rank,about	n3
位置	いち	place, situation, position, location	n3
住宅	じゅうたく	resident,housing	n3
住民	じゅうみん	citizens,inhabitants,residents,population	n3
体温	たいおん	temperature (body)	n3
体育	たいいく	physical education,gymnastics,athletics	n3
何	なに	what	n3
何か	なにか	something	n3
何で	なんで	Why?,What for?	n3
何でも	なんでも	by all means,everything	n3
何とか	なんとか	somehow,anyhow,one way or another	n3
余り	あまり	not very (used as adverb),not much	n3
余分	よぶん	extra,excess,surplus	n3
余裕	よゆう	surplus,composure,margin,room,time,allowance,scope,rope	n3
作品	さくひん	work,opus,performance,production	n3
作家	さっか	author,writer,novelist,artist	n3
作曲	さっきょく	composition,setting (of music)	n3
作業	さぎょう	work,operation,manufacturing,fatigue duty	n3
作法	さほう	manners,etiquette,propriety	n3
作物	さくもつ	produce (e.g. agricultural),crops	n3
使用	しよう	use,application,employment,utilization	n3
例	れい	instance,example,case	n3
供給	きょうきゅう	supply,provision	n3
依頼	いらい	(1) request, commission, dispatch,(2) dependence, trust	n3
価値	かち	value,worth,merit	n3
価格	かかく	price, value, cost	n3
便	びん	way,means	n3
便り	たより	news, tidings, information, correspondence, letter	n3
係	かかり	official, duty, person in charge	n3
保存	ほぞん	preservation, conservation, storage, maintenance	n3
保証	ほしょう	guarantee, security, assurance, pledge, warranty	n3
信じる	しんじる	to believe,to place trust in	n3
信仰	しんこう	(religious) faith,belief,creed	n3
信号	しんごう	traffic lights,signal,semaphore	n3
信用	しんよう	confidence,dependence,credit,faith	n3
信頼	しんらい	reliance,trust,confidence	n3
修正	しゅうせい	amendment,correction,revision,modification	n3
修理	しゅうり	repairing,mending	n3
俳優	はいゆう	actor,actress,player,performer	n3
個人	こじん	individual,private person,personal,private	n3
倒す	たおす	to throw down,to beat,to bring down,to blow down	n3
候補	こうほ	candidacy	n3
借金	しゃっきん	debt,loan,liabilities	n3
値	ね	value,price,cost,worth,merit	n3
値段	ねだん	price,cost	n3
偉大	いだい	greatness	n3
停留所	ていりゅうじょ	bus or tram stop	n3
健康	けんこう	health,sound,wholesome	n3
側	そば	side,edge,third person	n3
偶々	たまたま	casually,unexpectedly,accidentally,by chance	n3
偶然	ぐうぜん	(by) chance,unexpectedly,suddenly	n3
備える	そなえる	to furnish,to provide for,to equip,to install	n3
傷	きず	wound,injury,hurt,cut	n3
傾向	けいこう	tendency,trend,inclination	n3
僅か	わずか	only,merely,a little,small quantity	n3
働き	はたらき	work,labor	n3
優れる	すぐれる	to surpass,to outstrip,to excel	n3
優勝	ゆうしょう	overall victory,championship	n3
優秀	ゆうしゅう	superiority,excellence	n3
元	もと	(1) origin,original,(2) former	n3
先ず	まず	first (of all),to start with,about,almost,hardly (with neg. verb)	n3
先日	せんじつ	the other day,a few days ago	n3
光景	こうけい	scene,spectacle	n3
克服	こくふく	subjugation,conquest	n3
免許	めんきょ	license,permit,licence,certificate	n3
兎	うさぎ	rabbit, hare	n3
党	とう	party (political)	n3
入場	にゅうじょう	entrance,admission,entering	n3
入学	にゅうがく	entry to school or university,matriculation	n3
全く	まったく	really,truly,entirely,completely	n3
全て	すべて	all,the whole,entirely,in general,wholly	n3
全て	すべて	all,whole,entire,complete,overall,pan	n3
全体	ぜんたい	whole,entirety,whatever (is the matter)	n3
全員	ぜんいん	all members (unanimity),all hands,the whole crew	n3
全国	ぜんこく	country-wide,nation-wide,whole country,national	n3
全然	ぜんぜん	(1) wholly,entirely,completely,(2) not at all (with neg. verb)	n3
公平	こうへい	fairness,impartial,justice	n3
共に	ともに	sharing with,participate in	n3
共同	きょうどう	cooperation,association,collaboration,joint	n3
共通	きょうつう	commonness,community	n3
具体	ぐたい	concrete,tangible,material	n3
典型	てんけい	type,pattern,archetypal	n3
内	うち	inside	n3
内容	ないよう	subject, contents, substance,	n3
円	えん	circle, money	n3
再び	ふたたび	again,once more,a second time	n3
冒険	ぼうけん	risk,venture,adventure	n3
冗談	じょうだん	jest,joke	n3
冷静	れいせい	calm,composure,coolness,serenity	n3
凍る	こおる	to freeze,to be frozen over,to congeal	n3
処理	しょり	processing,dealing with,treatment,disposition,disposal	n3
出会い	であい	meeting,rendezvous,encounter	n3
出会う	であう	to meet by chance,to come across,to happen to encounter	n3
出席	しゅっせきする	attendance,presence, to attend	n3
出来るだけ	できるだけ	as (much) (soon) as possible	n3
出来事	できごと	incident,affair,happening,event	n3
出版	しゅっぱん	publication	n3
出発	しゅっぱつする	departure, to depart	n3
出身	しゅっしん	graduate from,come from	n3
刀	かたな	sword,saber,knife,engraving tool	n3
分	ぶ	dividing,part	n3
分	ぶん	dividing,part,segment	n3
分ける	わける	to divide,to separate	n3
分析	ぶんせき	analysis	n3
分野	ぶんや	field,sphere,realm,division,branch	n3
切れ	きれ	cloth,piece,cut,chop	n3
切れる	きれる	(1) to cut well,to be sharp,(2) to break (off)	n3
刈る	かる	to cut (hair),to mow (grass),to harvest	n3
刑事	けいじ	a police detective	n3
列	れつ	queue,line,row	n3
列車	れっしゃ	train (ordinary)	n3
判断	はんだん	judgement,decision	n3
別に	べつに	(not) particularly,nothing	n3
別れ	わかれ	parting,separation,farewell	n3
利口	りこう	clever,shrewd,bright,sharp,wise,intelligent	n3
利益	りえき	profits,gains,(political, economic) interest	n3
到着	とうちゃく	arrival	n3
制度	せいど	system,institution,organization	n3
制限	せいげん	restriction,restraint,limitation	n3
券	けん	ticket,coupon,bond,certificate	n3
刺激	しげき	stimulus,impetus,incentive	n3
前者	ぜんしゃ	the former	n3
前進	ぜんしん	advance,drive,progress	n3
割る	わる	to divide,to cut,to break,to halve	n3
劇	げき	drama,play	n3
劇場	げきじょう	theatre,playhouse	n3
加える	くわえる	to append,to sum up,to add (up)	n3
加わる	くわわる	to join in,to accede to,to increase,to gain in (influence)	n3
加減	かげん	addition and subtraction,allowance for	n3
劣る	おとる	to fall behind, to be inferior to	n3
助ける	たすける	to help,to save,to rescue	n3
助手	じょしゅ	helper,helpmeet,assistant,tutor	n3
努力	どりょく	great effort,exertion,endeavour,effort	n3
労働	ろうどう	manual labor,toil,work	n3
効く	きく	to be effective	n3
効果	こうか	effect,effectiveness,efficacy,result	n3
勇気	ゆうき	courage,bravery,valour,nerve,boldness	n3
勉強 / 勉強する	べんきょうする	study, work, to study, to sell (a thing) cheap	n3
動かす	うごかす	to move, to shift	n3
動詞	どうし	verb	n3
勘	かん	perception,intuition,the sixth sense	n3
勘定	かんじょう	calculation,counting,consideration	n3
務め	つとめ	(1) service,duty,	n3
勝ち	かち	win,victory	n3
勢い	いきおい	force, vigour, energy, spirit	n3
勤め	つとめ	(1) service, business, job(2) Buddhist religious services	n3
勧める	すすめる	to recommend,to advise,to encourage,to offer (wine)	n3
勿論	もちろん	of course,certainly,naturally	n3
匂い	におい	odour,scent,smell,stench	n3
包み	つつみ	bundle,package,parcel,bale	n3
化学	かがく	chemistry	n3
化粧	けしょう	make-up (cosmetic)	n3
区別	くべつ	distinction,differentiation,classification	n3
医師	いし	doctor, physician	n3
医療	いりょう	medical care, medical treatment	n3
十	じゅう	10,ten	n3
十	とお	10,ten	n3
半ば	なかば	middle,half,semi,halfway,partly	n3
協力	きょうりょく	cooperation,collaboration	n3
単なる	たんなる	mere,simple,sheer	n3
単に	たんに	simply,merely,only,solely	n3
単位	たんい	unit,denomination,credit (in school)	n3
単純	たんじゅん	simplicity	n3
単語	たんご	word,vocabulary,(usually) single-character word	n3
博士	はかせ	doctorate,PhD	n3
博物館	はくぶつかん	museum	n3
占める	しめる	(1) to comprise,to account for,to make up (of),(2) to hold,to occupy	n3
印	しるし	(1) mark,(2) symbol,(3) evidence	n3
印刷	いんさつ	printing	n3
印象	いんしょう	impression	n3
厄介	やっかい	trouble,burden,care,bother	n3
原	はら	field,plain,prairie,tundra,moor,wilderness	n3
去る	さる	to leave,to go away	n3
参加	さんか	participation	n3
参考	さんこう	reference,consultation	n3
又	また	again,and	n3
及ぼす	およぼす	to exert, to cause, to exercise	n3
友	とも	friend,companion,pal	n3
友人	ゆうじん	friend	n3
友情	ゆうじょう	friendship,fellowship	n3
双子	ふたご	twins,a twin	n3
反抗	はんこう	opposition,resistance	n3
収める	おさめる	to obtain, to reap, to pay, to supply, to accept	n3
収入	しゅうにゅう	income,receipts,revenue	n3
収穫	しゅうかく	harvest,crop,ingathering	n3
取り上げる	とりあげる	to take up,to pick up,to disqualify,to confiscate,to deprive	n3
取れる	とれる	to come off,to be taken off,to be removed	n3
受け取る	うけとる	to receive, to get, to accept, to take	n3
句	く	sentence	n3
叩く	たたく	to strike,to clap,to dust,to beat	n3
叫ぶ	さけぶ	to shout,to cry	n3
可	か	passable	n3
可能	かのう	possible,practicable,feasible	n3
台	だい	stand,rack,table,support, counter for machine	n3
叱る	しかる	to scold	n3
合わせる	あわせる	to join together, to be opposite, to face, to unite	n3
合図	あいず	sign, signal	n3
合格	ごうかく	success,passing (e.g. exam),eligibility	n3
合計	ごうけい	sum total,total amount	n3
同一	どういつ	identity,sameness,similarity	n3
同僚	どうりょう	coworker,colleague,associate	n3
同時	どうじ	simultaneous(ly),concurrent,same time,synchronous	n3
同様	どうよう	identical,equal to,same (kind),like	n3
名	な	name,reputation	n3
名人	めいじん	master,expert	n3
吐く	はく	to breathe out, to vomit	n3
向かい	むかい	facing,opposite,across the street,other side	n3
向く	むく	to face	n3
向ける	むける	to turn towards,to point	n3
吠える	ほえる	to bark,to bay,to howl,to bellow,to roar,to cry	n3
否	いや	no, the nose	n3
否定	ひてい	negation,denial,repudiation	n3
含む	ふくむ	to hold in the mouth,to bear in mind	n3
吸収	きゅうしゅう	absorption,suction,attraction	n3
周囲	しゅうい	surroundings,circumference,environs	n3
味方	みかた	friend,ally,supporter	n3
呼吸	こきゅう	breath,respiration	n3
命	いのち	,life, destiny	n3
命じる	めいじる	to order,to command,to appoint	n3
命令	めいれい	order,command,decree,directive,(software) instruction	n3
咳	せき	cough	n3
哀れ	あわれ	helpless, pity, sorrow, grief	n3
品	しな	thing,article,goods,dignity,article (goods),counter for meal courses	n3
品	ひん	elegance, grace, dignity,	n3
哲学	てつがく	philosophy	n3
唯	ただ	mere,sole,only	n3
唯	たった	only (use with a word which indicates numbers)	n3
唯一	ゆいいつ	only,sole,unique	n3
商人	しょうにん	trader,shopkeeper,merchant	n3
商品	しょうひん	commodity,article of commerce,goods,stock,merchandise	n3
商売	しょうばい	trade,business,commerce,transaction,occupation	n3
問い	とい	question,query	n3
善	ぜん	good,goodness,right,virtue	n3
喉	のど	throat	n3
喜び	よろこび	(a) joy,(a) delight,rapture,pleasure,gratification,rejoicing,congratulations,felicitations	n3
喧嘩	けんか	quarrel,(drunken) brawl,failure	n3
営業	えいぎょう	business, trade, management	n3
嘘	うそ	lie, falsehood, incorrect fact, inappropriate	n3
噂	うわさ	rumour, report, gossip, common talk	n3
器用	きよう	skillful,handy	n3
四	し / よん	four	n3
四	よん	four	n3
回	かい	counter for occurrences	n3
回す	まわす	to turn,to revolve	n3
回り	まわり	circumference,surroundings,circulation	n3
回復	かいふく	recovery (from illness),improvement, rehabilitation, restoration	n3
団体	だんたい	organization,association, a group	n3
困難	こんなん	difficulty,distress	n3
囲む	かこむ	to surround,to encircle	n3
図	ず	figure (e.g. Fig 1),drawing,picture,illustration	n3
図書	としょ	books	n3
国会	こっかい	National Diet,parliament,congress	n3
国境	こっきょう	national or state border	n3
国家	こっか	state,country,nation	n3
国民	こくみん	national,people,citizen	n3
国語	こくご	national language	n3
土	つち	earth,soil	n3
土地	とち	plot of land,lot,soil	n3
土曜 / 土曜日	どよう / どようび	Saturday	n3
土産	みやげ	present,souvenir	n3
地	ち	earth	n3
地下	ちか	basement,underground	n3
地位	ちい	(social) position,status	n3
地区	ちく	district,section,sector	n3
地域	ちいき	area,region	n3
地平線	ちへいせん	horizon	n3
地方	ちほう	area,locality,district,region,the coast	n3
地球	ちきゅう	the earth	n3
型	かた	mold,model,style,shape,data-type	n3
埃	ほこり	dust	n3
城	しろ	castle	n3
基	もと	basis	n3
基づく	もとづく	to be grounded on,to be based on,to be due to,to originate from	n3
基本	きほん	foundation,basis,standard	n3
報告	ほうこく	report,information	n3
場	ば	place,field (physics)	n3
場面	ばめん	scene,setting (e.g. of novel)	n3
塀	へい	wall,fence	n3
塔	とう	tower,pagoda	n3
塵	ごみ	dust,dirt rubbish	n3
境	さかい	border,boundary,mental state	n3
墓	はか	grave,tomb	n3
増す	ます	to increase,to grow	n3
増加	ぞうか	increase,addition	n3
売れる	うれる	to be sold	n3
変化	へんか	goblin,ghost,apparition,bugbear	n3
変更	へんこう	change,modification,alteration	n3
夕べ	ゆうべ	evening	n3
外す	はずす	to unfasten,to remove	n3
外交	がいこう	diplomacy	n3
外出	がいしゅつ	outing, going out	n3
多分	たぶん	perhaps,probably	n3
多少	たしょう	more or less,somewhat,a little,some	n3
夜	よ	evening,night	n3
夜中	よなか	midnight,dead of night	n3
夜明け	よあけ	dawn,daybreak	n3
夢中	むちゅう	daze,(in a) trance,ecstasy,delirium,engrossment	n3
大いに	おおいに	very, much, greatly	n3
大した	たいした	considerable,great,important,significant,a big deal	n3
大会	たいかい	convention,tournament,mass meeting,rally	n3
大使	たいし	ambassador	n3
大半	たいはん	majority,mostly,generally	n3
大変	たいへん	awful,dreadful,terrible,very	n3
大家	おおや	rich family, distinguished family	n3
大戦	たいせん	great war,great battle	n3
大抵	たいてい	usually,generally	n3
大気	たいき	the air, atmosphere	n3
大統領	だいとうりょう	president,chief executive	n3
大臣	だいじん	cabinet minister	n3
大部分	だいぶぶん	most part,greater part,majority	n3
大陸	たいりく	continent	n3
天候	てんこう	weather	n3
天然	てんねん	nature,spontaneity	n3
太陽	たいよう	sun,solar	n3
夫人	ふじん	wife,Mrs,madam	n3
夫婦	ふうふ	married couple,husband and wife	n3
失う	うしなう	to lose, to part with	n3
失望	しつぼう	disappointment,despair	n3
失業	しつぎょう	unemployment	n3
奇妙	きみょう	strange,queer,curious	n3
契約	けいやく	contract,compact,agreement	n3
奥	おく	interior, inner part	n3
奨学金	しょうがくきん	scholarship	n3
奪う	うばう	to snatch away	n3
女優	じょゆう	actress	n3
女子	じょし	woman,girl	n3
女王	じょおう	queen	n3
好み	このみ	liking,taste,choice	n3
好む	このむ	to like,to prefer	n3
妙	みょう	strange,unusual	n3
姉妹	しまい	sisters	n3
始まり	はじまり	origin,beginning	n3
委員	いいん	committee member	n3
姿	すがた	figure,shape,appearance	n3
婚約	こんやく	engagement,betrothal	n3
婦人	ふじん	woman,female	n3
嫁	よめ	bride,daughter-in-law	n3
嫌う	きらう	to hate,to dislike,to loathe	n3
嬉しい	うれしい	happy, glad, pleasant	n3
存在	そんざい	existence,being	n3
学	がく	learning,scholarship,erudition,knowledge	n3
学ぶ	まなぶ	to study (in depth),to learn,to take lessons in	n3
学問	がくもん	scholarship, study, learning	n3
学期	がっき	term (school)	n3
学習	がくしゅう	study,learning	n3
学者	がくしゃ	scholar	n3
孫	まご	grandchild	n3
宅	たく	house,home,husband	n3
宇宙	うちゅう	universe, cosmos, space	n3
守る	まもる	to protect,to obey,to guard,to abide (by the rules)	n3
安定	あんてい	stability, equilibrium	n3
完了	かんりょう	completion,conclusion	n3
完全	かんぜん	perfection,completeness	n3
完成	かんせい	(1) complete,completion,(2) perfection,accomplishment	n3
宗教	しゅうきょう	religion	n3
定期	ていき	fixed term	n3
宜しい	よろしい	(hon) good,OK,all right,fine,very well,will do,may,can	n3
宝	たから	treasure	n3
宝石	ほうせき	gem,jewel	n3
実	み	fruit,nut,seed,content,good result	n3
実に	じつに	indeed,truly,surely	n3
実は	じつは	as a matter of fact,by the way	n3
実施	じっし	enforcement,enact,put into practice,carry out,operation	n3
実現	じつげん	implementation,materialization,realization	n3
実行	じっこう	practice,performance,execution (e.g. program),realization	n3
実際	じっさい	practical,actual condition,status quo	n3
実験	じっけん	experiment	n3
害	がい	injury, harm, evil influence, damage	n3
家事	かじ	housework,domestic chores	n3
家具	かぐ	furniture	n3
家賃	やちん	rent	n3
容易	ようい	easy,simple,plain	n3
宿	やど	inn,lodging	n3
宿泊	しゅくはく	lodging	n3
寄付	きふ	contribution,donation	n3
密な	みつな	dense, thick	n3
寧ろ	むしろ	rather,better,instead	n3
審判	しんぱん	refereeing,trial,judgement,umpire,referee	n3
対	つい	pair,couple,set	n3
対する	たいする	to face,to confront,to oppose	n3
対象	たいしょう	target,object (of worship, study, etc),subject (of taxation, etc)	n3
専攻	せんこう	major subject,special study	n3
尊敬	そんけい	respect,esteem,reverence,honour	n3
尊重	そんちょう	respect,esteem,regard	n3
小	しょう	small	n3
小包	こづつみ	parcel,package	n3
小屋	こや	hut,cabin,shed,(animal) pen	n3
小麦	こむぎ	wheat	n3
少々	しょうしょう	just a minute,small quantity	n3
少しも	すこしも	anything of,not one bit	n3
少女	しょうじょ	daughter,young lady,virgin,maiden,little girl	n3
少年	しょうねん	boys,juveniles	n3
尤も	もっとも	quite right,plausible,natural,but then,although	n3
就く	つく	to take (seat, position),to get (a job)	n3
就職	しゅうしょく	finding employment,inauguration	n3
尻	しり	buttocks,bottom	n3
局	きょく	a bureau, department	n3
居る	おる	to be (animate),to be, to exist	n3
居眠り	いねむり	dozing, nodding off	n3
居間	いま	living room (western style)	n3
届く	とどく	to reach	n3
屋根	やね	roof	n3
履く	はく	to wear,to put on (lower body)	n3
岩	いわ	rock, crag	n3
岸	きし	bank,coast,shore	n3
嵐	あらし	storm, tempest	n3
川	かわ	river	n3
州	しゅう	a state, province, county	n3
州	す	sandbank	n3
巣	す	nest,rookery,breeding place,beehive,cobweb	n3
左右	さゆう	(1) left and right,(2) influence,control,domination	n3
巨大	きょだい	huge,gigantic,enormous	n3
差	さ	difference,variation	n3
差別	さべつ	discrimination,distinction,differentiation	n3
市	いち	market, fair	n3
市場	いちば	(the) market (as a concept)	n3
布	ぬの	cloth	n3
希望	きぼう	hope,wish,aspiration	n3
帯	おび	band (e.g. conduction, valence)	n3
帰宅	きたく	returning home	n3
常に	つねに	always,constantly	n3
常識	じょうしき	common sense	n3
幅	はば	width,breadth	n3
幕	まく	curtain,bunting,act (in play)	n3
平ら	たいら	flatness,level,smooth,calm,plain	n3
平和	へいわ	peace,harmony	n3
平均	へいきん	equilibrium,balance,average,mean	n3
平等	びょうどう	equality (a),impartiality,evenness	n3
年中	ねんじゅう	whole year,always,everyday	n3
年代	ねんだい	age,era,period,date	n3
年寄	としより	old people,the aged	n3
年月	としつき(ねんげつ）	months and years	n3
年月	ねんげつ	months and years	n3
年間	ねんかん	year	n3
年齢	ねんれい	age,years	n3
幸い	さいわい	happiness,blessedness	n3
幸せ	しあわせ	happiness,good fortune,luck,blessing	n3
幸福	こうふく	happiness,blessedness	n3
幸運	こううん	good luck,fortune	n3
幼い	おさない	very young, childish	n3
幾つ	いくつ	how many?, how old?	n3
幾ら	いくら	how much?,	n3
広がる	ひろがる	to spread (out),to extend,to stretch,to reach to,to get around	n3
広告	こうこく	advertisement	n3
床	ゆか	floor	n3
底	そこ	bottom,sole	n3
度	たび	counter for occurrences	n3
度	ど	counter for occurrences	n3
座席	ざせき	seat	n3
延期	えんき	postponement, adjournment	n3
建築	けんちく	construction,architecture	n3
建設	けんせつ	construction,establishment	n3
弁当	べんとう	box lunch	n3
式	しき	equation,formula,ceremony	n3
引っ張る	ひっぱる	(1) to pull,to draw,to stretch,to drag,(2) to pull the ball (baseball)	n3
引用	いんよう	quotation, citation	n3
引退	いんたい	retire	n3
張る	はる	to stick,to paste	n3
強力	きょうりょく	herculean strength,mountain carrier-guide	n3
強盗	ごうとう	robbery,burglary	n3
強調	きょうちょう	emphasis,stress,stressed point	n3
弾	たま	bullet,shot,shell	n3
当たる	あたる	to be hit, to be successful, to be equivalent to	n3
当てる	あてる	to hit, to apply a patch	n3
当時	とうじ	at that time,in those days	n3
形	かたち	shape, form	n3
影	かげ	shade, shadow, other side	n3
影響	えいきょう	influence, effect	n3
役	やく	use,service,role,position	n3
役割	やくわり	part,assigning (allotment of) parts,role,duties	n3
彼等	かれら	they (usually male)	n3
後	ご	afterwards,since then,in the future	n3
後	のち	afterwards,since then,in the future	n3
後ろ	うしろ	afterwards, since then, in the future, behind	n3
後者	こうしゃ	the latter	n3
徐々に	じょじょに	slowly,little by little,gradually,steadily,quietly	n3
従う	したがう	to abide (by the rules),to obey,to follow,to accompany	n3
従兄弟	いとこ	cousin (male)	n3
得る	うる	to get, to gain, to win	n3
得る	える	to get, to gain, to win	n3
得意	とくい	pride,triumph,prosperity	n3
御	お	honourable	n3
微妙	びみょう	delicate,subtle	n3
微笑む	ほほえむ	to smile	n3
徹夜	てつや	all night,all night vigil,sleepless night	n3
徹底	てってい	thoroughness,completeness	n3
心理	しんり	pshcyology, mental state	n3
心臓	しんぞう	heart (organ)	n3
心配	しんぱいする	worry,concern,anxiety,care, to worry	n3
必ずしも	かならずしも	(not) always,(not) necessarily,(not) all,(not) entirely	n3
必死	ひっし	inevitable death,desperation,frantic,inevitable result	n3
応じる	おうじる	to respond, to satisfy, to accept, to comply with, to apply for	n3
快適	かいてき	pleasant, agreeable, comfortable	n3
思い出	おもいで	memories, recollections, reminiscence	n3
思わず	おもわず	unintentional, spontaneous	n3
思想	しそう	thought,idea	n3
怠ける	なまける	to be idle,to neglect	n3
急に	きゅうに	suddenly	n3
急激	きゅうげき	sudden,precipitous,radical	n3
急速	きゅうそく	rapid (e.g. progress)	n3
性	せい	sex,gender	n3
性格	せいかく	character,personality	n3
怪我	けがする	injury (to animate object),hurt, to injure	n3
恋	こい	love,tender passion	n3
恋人	こいびと	lover,sweetheart	n3
恐れる	おそれる	to fear, to be afraid of	n3
恐ろしい	おそろしい	terrible, dreadful	n3
恐怖	きょうふ	be afraid,dread,dismay,terror	n3
恩	おん	favour, obligation, debt of gratitude	n3
息	いき	breath, tone	n3
患者	かんじゃ	a patient	n3
悩む	なやむ	to be worried,to be troubled	n3
悪口	わるくち	abuse,insult,slander,evil speaking	n3
悪魔	あくま	devil, demon, evil spirit	n3
悲しむ	かなしむ	to be sad,to mourn for,to regret	n3
悲劇	ひげき	tragedy	n3
情報	じょうほう	information,(military) intelligence	n3
想像	そうぞう	imagination,guess	n3
愉快	ゆかい	pleasant,happy	n3
意外	いがい	unexpected, surprising	n3
意志	いし	will, volition	n3
意思	いし	mind, intention	n3
意識	いしき	consciousness, senses	n3
愛	あい	love	n3
愛する	あいする	to love	n3
愛情	あいじょう	love, affection	n3
感じ	かんじ	feeling,sense,impression	n3
感じる	かんじる	to feel,to sense,to experience	n3
感動	かんどう	being deeply moved,excitement,impression,deep emotion	n3
感心	かんしん	admiration,Well done!	n3
感情	かんじょう	emotion(s),feeling(s),sentiment	n3
感覚	かんかく	sense,sensation	n3
感謝	かんしゃ	thanks,gratitude	n3
態度	たいど	attitude,manner	n3
慎重	しんちょう	discretion,prudence	n3
憲法	けんぽう	constitution	n3
成る	なる	to become	n3
成人	せいじん	adult	n3
成功	せいこう	success,hit	n3
成績	せいせき	results,record	n3
成長	せいちょう	growth,grow to adulthood	n3
我々	われわれ	we	n3
我慢	がまん	patience,endurance,perseverance	n3
或	ある	a certain...,some...	n3
戦い	たたかい	battle,fight,struggle,conflict	n3
戦う	たたかう	to fight,to battle,to combat	n3
戻す	もどす	to restore,to put back,to return	n3
所為	せい	cause,reason,fault	n3
手伝い	てつだい	help,helper,assistant	n3
手品	てじな	sleight of hand,conjuring trick,magic,juggling	n3
手段	しゅだん	means,way,measure	n3
手術	しゅじゅつ	surgical operation	n3
手間	てま	time,labour	n3
才能	さいのう	talent,ability	n3
打つ	ぶつ	to hit,to strike	n3
扱う	あつかう	to handle, to deal with, to treat	n3
批判	ひはん	criticism,judgement,comment	n3
批評	ひひょう	criticism,review,commentary	n3
承知	しょうちする	consent,acceptance,assent,admitting, to consent	n3
承認	しょうにん	recognition,acknowledgement,approval,consent,agreement	n3
技師	ぎし	engineer,technician	n3
投票	とうひょう	voting,poll	n3
抜く	ぬく	to extract,to omit,to surpass,to draw out,to unplug	n3
抜ける	ぬける	to come out,to fall out,to be omitted	n3
抱える	かかえる	to hold or carry under or in the arms	n3
抱く	いだく	(sl) to embrace, to hug, to harbour, to entertain	n3
抵抗	ていこう	resistance,opposition, electrical resistance,	n3
担当	たんとう	(in) charge	n3
拍手	はくしゅ	clapping hands,applause	n3
招く	まねく	to invite	n3
招待	しょうたいする	invitation, to invite	n3
拡大	かくだい	magnification, enlargement	n3
持ち上げる	もちあげる	to raise,to lift up,to flatter	n3
指す	さす	to point,to put up umbrella,to play	n3
指導	しどう	leadership,guidance,coaching	n3
振る	ふる	(1) to wave,to shake,to swing,(2) to sprinkle,(3) to cast (actor),to allocate (work)	n3
捕まる	つかまる	to be caught,to be arrested	n3
掃除	そうじ / そうじする	cleaning,sweeping, to clean, to sweep	n3
掛かる	かかる	to take (e.g. time, money, etc),to hang	n3
推薦	すいせん	recommendation	n3
掲示	けいじ	notice,bulletin	n3
掴む	つかむ	to seize,to catch,to grasp	n3
描く	えがく	to draw, to paint, to sketch, to depict, to describe	n3
描く	かく	to draw,to paint,to sketch,to depict,to describe	n3
提出	ていしゅつ	presentation,submission,filing	n3
提案	ていあん	proposal,proposition,suggestion	n3
握る	にぎる	to grasp,to hold a (thing) in one's hand, grip	n3
握手	あくしゅ	handshake	n3
援助	えんじょ	assistance, aid, support	n3
損	そん	loss,disadvantage	n3
損害	そんがい	damage,injury,loss	n3
撃つ	うつ	to attack, to defeat, to destroy	n3
操作	そうさ	operation,management,processing	n3
支える	ささえる	to support, to hold, maintain	n3
支出	ししゅつ	expenditure,expenses	n3
支店	してん	branch store (office)	n3
支度	したくする	preparation, to prepare	n3
支払	しはらい	payment	n3
支払う	しはらう	to pay	n3
支給	しきゅう	payment,allowance	n3
支配	しはい	rule,control,direction	n3
改善	かいぜん	betterment, improvement	n3
攻撃	こうげき	attack,strike,offensive,criticism,censure	n3
放す	はなす	to separate,to set free	n3
放送 / 放送する	ほうそうする	broadcast, broadcasting, to broadcast	n3
政府	せいふ	government,administration	n3
故郷	こきょう	home town,birthplace,old village,historic village	n3
故障	こしょう	break-down,failure,accident,out of order	n3
救う	すくう	to rescue from,to help out of	n3
救助	きゅうじょ	relief,aid,rescue	n3
教師	きょうし	teacher (classroom)	n3
教授	きょうじゅ	teaching,instruction,professor	n3
教科書	きょうかしょ	text book	n3
散歩	さんぽ	walk,stroll	n3
敬意	けいい	respect,honour	n3
数	かず	number,figure	n3
数	すう	number,figure	n3
数える	かぞえる	to count	n3
数字	すうじ	numeral,figure	n3
整理	せいり	sorting,arrangement,adjustment,regulation	n3
敵	てき	enemy,rival	n3
文	ぶん	sentence	n3
文句	もんく	phrase,complaint	n3
文字	もじ	letter (of alphabet),character	n3
文字	もんじ	letter (of alphabet),character	n3
文明	ぶんめい	civilization,culture	n3
料金	りょうきん	fee,charge,fare	n3
断る	ことわる	to refuse,to decline,to dismiss	n3
新た	あらた	new, fresh, novel	n3
新鮮	しんせん	fresh	n3
方	ほう	side	n3
方々	かたがた	persons,this and that,here and there,everywhere	n3
方々	ほうぼう	persons,this and that,here and there,everywhere	n3
方向	ほうこう	direction,course,way	n3
方法	ほうほう	method,manner,way,means,technique	n3
旅	たび	travel,trip,journey	n3
旗	はた	flag	n3
既に	すでに	already,too late	n3
日	にち	sun,sunshine,day	n3
日中	にっちゅう	daytime,broad daylight	n3
日付	ひづけ	date,dating	n3
日光	にっこう	sunlight	n3
日常	にちじょう	ordinary,regular,everyday,usual	n3
日曜	にちよう	Sunday	n3
日本	にっぽん / にほん	Japan	n3
旧	きゅう	ex-	n3
昇る	のぼる	to arise,to ascend,to go up	n3
明かり	あかり	lamplight, light (in general),brightness	n3
明ける	あける	to dawn, to become daylight	n3
明らか	あきらか	obvious, evident, clear	n3
明後日	みょうごにち	day after tomorrow	n3
明確	めいかく	clear up,clarify,define	n3
是非	ぜひ	certainly,without fail	n3
昼食	ちゅうしょく	lunch,midday meal	n3
時	とき	(1) time,hour,(2) occasion,moment	n3
時刻	じこく	instant,time,moment	n3
時期	じき	time,season,period	n3
普段	ふだん	usually,habitually,ordinarily,always	n3
景気	けいき	business climate, condition,state	n3
暖かい	あたたか(い)	warm, mild	n3
暗記	あんき	memorization, learning by heart	n3
暮らし	くらし	living,livelihood,subsistence,circumstances	n3
暮らす	くらす	to live,to get along	n3
暮れ	くれ	year end,sunset,nightfall,end	n3
曇	くもり	cloudiness,cloudy weather,shadow	n3
曜日	ようび	day of the week	n3
更に	さらに	furthermore,again,after all,more and more,moreover	n3
書斎	しょさい	study	n3
書物	しょもつ	books	n3
書類	しょるい	documents,official papers	n3
替える / 換える	かえる	to exchange, to interchange, to substitute, to replace	n3
最も	もっとも	most,extremely	n3
最中	さいちゅう	in the middle of	n3
最低	さいてい	least,lowest,worst	n3
最終	さいしゅう	last,final,closing	n3
最高	さいこう	highest,supreme,the most	n3
月	つき	moon,month	n3
月曜	げつよう / げつようび	Monday	n3
有る	ある	to be, to have(used for inanimate objects)	n3
有利	ゆうり	advantageous,better,profitable,lucrative	n3
有効	ゆうこう	validity,availability,effectiveness	n3
有能	ゆうのう	able,capable,efficient,skill	n3
服装	ふくそう	dress, clothes	n3
望み	のぞみ	wish,desire,(a) hope	n3
望む	のぞむ	to desire,to wish for,to see,to command (a view of)	n3
期待	きたい	expectation,anticipation,hope	n3
期間	きかん	period,term	n3
木曜 / 木曜日	もくよう / もくようび	Thursday	n3
未だ	まだ	yet,still,more,besides	n3
未来	みらい	future (life, tense)	n3
末	すえ	the end of,powder	n3
本人	ほんにん	the person himself	n3
本当	ほんとう / ほんと	truth,reality	n3
本物	ほんもの	genuine article	n3
札	さつ	(1) token,label,(2) ticket,(3) charm	n3
材料	ざいりょう	ingredients,material	n3
束	たば	handbreadth,bundle	n3
条件	じょうけん	conditions,terms	n3
来	らい	,for (10 days),next (year)	n3
松	まつ	(1) pine tree,(2) highest (of a three-tier ranking system)	n3
板	いた	board, plank	n3
柄	え	handle, grip	n3
柄	がら	pattern	n3
栄養	えいよう	nutrition, nourishment	n3
株	かぶ	share,stock,stump (of tree)	n3
根	ね	root	n3
格好	かっこう	shape,form,posture,suitability,appearance	n3
案	あん	plan, suffix meaning draft	n3
案内	あんないする	information, guidance, leading, to guide	n3
桜	さくら	cherry blossom,cherry tree	n3
梅	うめ	plum, plum-tree, lowest (of a three-tier ranking system)	n3
梅雨	つゆ	rainy season,rain during the rainy season	n3
梅雨	ばいう	rainy season,rain during the rainy season	n3
棒	ぼう	pole,rod,stick	n3
椅子	いす	chair	n3
植物	しょくぶつ	plant,vegetation	n3
検査	けんさ	inspection (e.g. customs, factory),examination	n3
検討	けんとう	consideration,examination,investigation,study,scrutiny	n3
極	きょく	a pole	n3
楽	らく	comfort,ease	n3
構う	かまう	to mind,to care about,to be concerned about	n3
構成	こうせい	organization,composition	n3
様	よう	way,manner,kind	n3
様々	さまざま	varied,various	n3
様子	ようす	aspect,state,appearance	n3
模様	もよう	pattern,figure,design	n3
権利	けんり	right,privilege	n3
横切る	よこぎる	to cross (e.g. arms),to traverse	n3
横断	おうだん	crossing	n3
機嫌	きげん	humour,temper,mood	n3
機械	きかい	machine,mechanism	n3
機能	きのう	function,faculty	n3
機関	きかん	organ,mechanism,facility,engine	n3
欠ける	かける	to be lacking	n3
欠席	けっせき	absence,non-attendance	n3
欠点	けってん	faults,defect,weakness	n3
欠陥	けっかん	defect,fault,deficiency	n3
次々	つぎつぎ	in succession,one by one	n3
次第	しだい	(1) order,precedence,(2) circumstances,(3) immediate(ly)	n3
歌手	かしゅ	singer	n3
歓迎	かんげい	welcome,reception	n3
止す	よす	to cease,to abolish,to resign,to give up	n3
正	せい	(logical) true,regular	n3
正午	しょうご	noon,mid-day	n3
正式	せいしき	due form,official,formality	n3
正直	しょうじき	honesty,integrity,frankness	n3
正確	せいかく	accurate,punctuality,exactness,authenticity,veracity	n3
武器	ぶき	weapon,arms,ordinance	n3
歩道	ほどう	footpath,walkway,sidewalk	n3
死亡	しぼう	death,mortality	n3
残す	のこす	to leave (behind, over),to bequeath,to save,to reserve	n3
残り	のこり	remnant,residue,remaining,left-over	n3
段	だん	step,stair,flight of steps,grade,rank,level	n3
殺す	ころす	to kill	n3
母親	ははおや	mother	n3
毒	どく	poison,toxicant	n3
比較	ひかく	comparison	n3
毛布	もうふ	blanket	n3
氏	し	family name,lineage,birth	n3
気に入る	きにいる	to be pleased with,to suit	n3
気の毒	きのどく	pitiful,a pity	n3
気付く	きづく	to notice,to recognize,to become aware of	n3
気候	きこう	climate	n3
気味	きみ	-like,-looking,-looked	n3
気温	きおん	temperature	n3
水準	すいじゅん	(1) level, standard, (2) water level	n3
氷	こおり	ice,hail	n3
永久	えいきゅう	eternity ,perpetuity, immortality	n3
永遠	えいえん	eternity, perpetuity, immortality, permanence	n3
求める	もとめる	to seek,to request,to demand,to want,to wish for,to search for,to pursue (pleasure),to hunt (a job),	n3
汗	あせ	sweat, perspiration	n3
汚染	おせん	pollution, contamination	n3
決まり	きまり	settlement,conclusion,regulation,rule	n3
決定	けってい	decision,determination	n3
決心	けっしん	determination,resolution	n3
沈む	しずむ	to sink,to feel depressed	n3
沖	おき	open sea	n3
河	かわ	river,stream	n3
油	あぶら	oil	n3
泉	いずみ	spring, fountain	n3
法	ほう	Act (law: the X Act)	n3
泡	あわ	bubble, foam, froth, head on beer	n3
波	なみ	wave	n3
泥	どろ	mud	n3
注	ちゅう	annotation,explanatory note	n3
注ぐ	そそぐ	to pour (into),to irrigate,to pay,to fill,to feed (e.g. a fire)	n3
注ぐ	つぐ	to pour (into),to irrigate,to pay	n3
注文	ちゅうもん	order,request	n3
注目	ちゅうもく	notice,attention,observation	n3
泳ぎ	およぎ	swimming	n3
活動	かつどう	action,activity	n3
活気	かっき	energy,liveliness	n3
活用	かつよう	conjugation,practical use	n3
流す	ながす	to drain,to float,to shed (blood, tears),to cruise (e.g. taxi)	n3
流れ	ながれ	stream,current	n3
流れる	ながれる	to stream,to flow,to run (ink),to be washed away	n3
流行	りゅうこう	fashionable,fad,in vogue,prevailing	n3
浴びる	あびる	to bathe, to bask in the sun, to shower	n3
海外	かいがい	foreign, abroad, overseas	n3
消費	しょうひ	consumption,expenditure	n3
消防	しょうぼう	fire fighting,fire department	n3
涙	なみだ	tear	n3
深刻	しんこく	serious	n3
混乱	こんらん	disorder,chaos,confusion,mayhem	n3
混雑	こんざつ	congestion,	n3
清潔	せいけつ	clean	n3
済ませる	すませる	to be finished	n3
渋滞	じゅうたい	congestion (e.g. traffic),delay,stagnation	n3
減らす	へらす	to abate,to decrease,to diminish,to shorten	n3
減る	へる	to decrease (in size or number),to diminish,to abate	n3
温度	おんど	temperature	n3
温暖	おんだん	warmth	n3
湾	わん	bay,gulf,inlet	n3
満ちる	みちる	to be full,to rise (tide),to mature,to expire	n3
満足	まんぞく	satisfaction	n3
準備	じゅんびする	preparation,arrangements,provision,reserve, to prepare	n3
溺れる	おぼれる	to be drowned, to indulge in	n3
滅多に	めったに	rarely (with neg. verb),seldom	n3
滞在	たいざい	stay,sojourn	n3
演奏	えんそう	musical performance	n3
演技	えんぎ	acting, performance	n3
演説	えんぜつ	speech, address	n3
激しい	はげしい	violent,vehement,intense	n3
濃い	こい	thick (as of color, liquid),dense,strong	n3
濠	ほり	moat	n3
濡れる	ぬれる	to get wet	n3
火曜	かよう	(abbr) Tuesday	n3
火災	かさい	conflagration,fire	n3
灯	ひ	light	n3
灰	はい	ash	n3
炎	ほのお	flame	n3
為る	する	to do	n3
為る	なる	to change,to be of use,to reach to	n3
無	ぶ	nothing,naught,nil,zero	n3
無	む	nothing,naught,nil,zero	n3
無し	なし	without	n3
無事	ぶじ	safety,peace,quietness	n3
無料	むりょう	free,no charge	n3
無視	むし	disregard,ignore	n3
無駄	むだ	futility,uselessness	n3
煙	けむり	smoke,fumes	n3
熱中する	ねっちゅうする	to devote oneself, be devoted to, be crazy about	n3
熱帯	ねったい	tropics	n3
熱心	ねっしん	zeal,enthusiasm	n3
燃える	もえる	to burn	n3
爆発	ばくはつ	explosion,detonation,eruption	n3
父親	ちちおや	father	n3
牛	うし	cattle, cow	n3
物事	ものごと	things,everything	n3
物価	ぶっか	prices of commodities,prices (in general)	n3
物理	ぶつり	physics	n3
物語	ものがたり	tale,story,legend	n3
物質	ぶっしつ	material,substance	n3
物音	ものおと	sounds	n3
特徴	とくちょう	distinctive feature,characteristic	n3
犯人	はんにん	offender,criminal	n3
犯罪	はんざい	crime	n3
状態	じょうたい	condition,situation,circumstances,state	n3
状況	じょうきょう	state of affairs,situation,circumstances	n3
狂う	くるう	to go mad,to get out of order	n3
独り	ひとり	alone,	n3
独特	どくとく	peculiarity,uniqueness,characteristic	n3
独立	どくりつ	independence (e.g. Ind. Day),self-support	n3
独身	どくしん	bachelorhood,single,unmarried,celibate	n3
猿	さる	monkey	n3
率	りつ	rate,ratio,proportion,percentage	n3
玉	たま	ball,sphere,coin	n3
王	おう	king, ruler, sovereign, monarch	n3
王子	おうじ	prince	n3
王様	おうさま	king	n3
現す	あらわす	to show, to indicate, to display	n3
現れ	あらわれ	embodiment, materialization	n3
現れる	あらわれる	(1) to appear, to come in sight, to become visible,(2) to express oneself	n3
現代	げんだい	nowadays,modern times,present-day	n3
現在	げんざい	present,up to now,nowadays,modern times,current	n3
現場	げんば	actual spot,scene,scene of the crime	n3
現実	げんじつ	reality	n3
現状	げんじょう	present condition,existing state,status quo	n3
現象	げんしょう	phenomenon	n3
現金	げんきん	cash,ready money,mercenary,	n3
球	きゅう	globe,sphere,ball	n3
球	たま	globe,sphere,ball	n3
理想	りそう	ideal	n3
理解	りかい	understanding,comprehension	n3
環境	かんきょう	environment,circumstance	n3
瓶	びん	bottle	n3
生	なま	(1) draft (beer),(2) raw,unprocessed	n3
生き物	いきもの	living thing, animal	n3
生じる	しょうじる	to produce,to yield,to result from,to arise,to be generated	n3
生まれ	うまれ	birth, birth-place	n3
生命	せいめい	life,existence	n3
生地	きじ	birthplace	n3
生物	せいぶつ	raw food	n3
生産	せいさん	production,manufacture	n3
用いる	もちいる	to use,to make use of	n3
用心	ようじん	care,precaution,guarding,caution	n3
田	た	rice field	n3
申し訳	もうしわけ	apology,excuse	n3
申し込む	もうしこむ	to apply for,to make an application	n3
男の人	おとこのひと	man	n3
男子	だんし	a boy, a man, a male	n3
画家	がか	painter, artist	n3
畑	はたけ	field	n3
留める	とめる	to fasten,to turn off,to detain	n3
留学	りゅうがく	studying abroad	n3
番	ばん	counter for a number	n3
異なる	ことなる	to differ,to vary,to disagree	n3
異常	いじょう	strangeness, abnormality, disorder	n3
疑う	うたがう	to doubt, to distrust, to be suspicious of, to suspect	n3
疑問	ぎもん	question,problem,doubt,guess	n3
疲れ	つかれ	tiredness,fatigue	n3
症状	しょうじょう	symptoms,condition	n3
痛み	いたみ	pain, ache, sore, grief, distress	n3
癖	くせ	a habit (often a bad habit),peculiarity	n3
発展	はってん	development,growth	n3
発明	はつめい	invention	n3
発行	はっこう	issue (publications)	n3
発表	はっぴょう	announcement,publication	n3
発見	はっけん	discovery,detection,finding	n3
発車	はっしゃ	departure of a vehicle	n3
発達	はったつ	development,growth	n3
登山	とざん	mountain-climbing	n3
皆	みんな	all,everyone,everybody	n3
皮	かわ	skin,hide,leather,fur,pelt,bark,shell	n3
皿	さら	plate,dish	n3
盛り	さかり	the highest, the peak, prime	n3
監督	かんとく	supervision,control,superintendence	n3
目標	もくひょう	mark,objective,target	n3
目的	もくてき	purpose,goal,aim,objective,intention	n3
直ちに	ただちに	at once,immediately,directly,in person	n3
直に	じかに	immediately,readily,directly	n3
直接	ちょくせつ	direct,immediate,personal,firsthand	n3
相当	そうとう	suitable,fair,tolerable,proper	n3
相手	あいて	companion, partner, company	n3
相続	そうぞく	succession,inheritance	n3
相談	そうだん / そうだんする	consultation,discussion，to consult, to discuss	n3
省く	はぶく	to omit,to eliminate,to curtail,to economize	n3
県	けん	prefecture	n3
真っ直ぐ	まっすぐ	straight (ahead),direct,upright	n3
真っ赤	まっか	deep red,flushed (of face)	n3
真似	まね	mimicry,imitation,behavior,pretense	n3
真剣	しんけん	seriousness,earnestness	n3
真面目	まじめ	diligent,serious,honest	n3
眺め	ながめ	scene,view,prospect,outlook	n3
眺める	ながめる	to view,to gaze at	n3
睡眠	すいみん	sleep	n3
瞬間	しゅんかん	moment,second,instant	n3
知らせ	しらせ	notice	n3
知事	ちじ	prefectural governor	n3
知恵	ちえ	wisdom, intelligence, advice	n3
知能	ちのう	intelligence,brains	n3
知識	ちしき	knowledge,information	n3
石油	せきゆ	oil,petroleum,kerosene	n3
石炭	せきたん	coal	n3
砂漠	さばく	desert	n3
破る	やぶる	to tear,to violate,to defeat,to smash,to destroy	n3
破産	はさん	(personal) bankruptcy	n3
硬い	かたい	solid,hard (esp. metal, stone),unpolished writing	n3
硬貨	こうか	coin	n3
確かめる	たしかめる	to ascertain, confirm	n3
確実	かくじつ	certainty, reliability, soundness	n3
確認	かくにん	affirmation, confirmation	n3
示す	しめす	to denote,to show,to point out,to indicate	n3
礼	れい	expression of gratitude	n3
礼儀	れいぎ	manners,courtesy,etiquette	n3
祝い	いわい	celebration, festival	n3
祝う	いわう	to congratulate, to celebrate	n3
神	かみ	god	n3
神経	しんけい	nerve,sensitivity	n3
祭	まつり	festival,feast	n3
禁止	きんし	prohibition,ban	n3
禁煙	きんえん	No Smoking!	n3
科目	かもく	(school) subject,curriculum,course	n3
秒	びょう	second (60th min)	n3
秘密	ひみつ	secret,secrecy	n3
移す	うつす	to remove, to transfer, to infect	n3
移動	いどう	removal, migration, movement	n3
程	ほど	degree,extent,bounds,limit	n3
程度	ていど	degree,amount,grade,standard,of the order of (following a number)	n3
税	ぜい	a tax	n3
税金	ぜいきん	tax,duty	n3
種	たね	(1) seed,(2) material,(3) cause,source	n3
種類	しゅるい	variety,kind,type	n3
稲	いね	rice-plant	n3
稼ぐ	かせぐ	to earn income,to labor	n3
穀物	こくもつ	grain,cereal,corn	n3
積もる	つもる	to pile up	n3
積極的	せっきょくてき	positive,active,proactive	n3
穏やか	おだやか	calm, gentle, quiet	n3
穴	あな	hole	n3
空	から	empty	n3
空き	あき	room, time to spare, emptiness	n3
空く	すく	(1) to open,to become empty,(2) to be less crowded	n3
突然	とつぜん	abruptly,suddenly,unexpectedly,all at once	n3
立ち上がる	たちあがる	to stand up	n3
立場	たちば	standpoint,position,situation	n3
立派	りっぱ	splendid,fine,handsome,elegant,imposing,prominent,legal,legitimate	n3
章	しょう	(1) chapter,section,(2) medal	n3
端	はし	end (e.g. of street),edge,tip,margin,point	n3
競技	きょうぎ	game,match,contest	n3
笑い	わらい	laugh,laughter,smile	n3
笑顔	えがお	smiling face	n3
笛	ふえ	flute,pipe	n3
筆	ふで	writing brush	n3
等	など	et cetera,etc.,and the like	n3
等しい	ひとしい	equal	n3
筋	すじ	muscle,string,line	n3
筋肉	きんにく	muscle,sinew	n3
答案	とうあん	examination paper,examination script	n3
管	くだ	pipe,tube	n3
管理	かんり	control,management (e.g. of a business)	n3
節	ふし	tune,tone,knot,knob,point	n3
節約	せつやく	economising,saving	n3
範囲	はんい	extent,scope,sphere,range	n3
籠	かご	basket,cage	n3
粉	こな	flour,meal,powder	n3
粗い	あらい	Coarse	n3
粗末	そまつ	crude,rough,plain,humble	n3
精々	せいぜい	at the most,at best,to the utmost,as much (far) as possible	n3
精神	せいしん	mind,soul,heart,spirit,intention	n3
約	やく	approximately,about,some	n3
納得	なっとく	consent,assent,understanding	n3
紐	ひも	(1) string,cord,(2) pimp	n3
級	きゅう	class, grade, rank,school class, grade	n3
素晴らしい	すばらしい	wonderful,splendid,magnificent	n3
終える	おえる	to finish	n3
組	くみ	class,group,team,set	n3
組む	くむ	to put together	n3
組合	くみあい	association,union	n3
組織	そしき	(1) organization,(2) structure,construction,(3) tissue,(4) system	n3
経つ	たつ	to pass,to lapse	n3
経営	けいえい	management,administration	n3
経由	けいゆ	go by the way,via	n3
経験	けいけんする	experience, to experience	n3
結ぶ	むすぶ	to tie,to bind,to link	n3
結局	けっきょく	after all,eventually	n3
結果	けっか	result,consequence	n3
結論	けつろん	conclusion	n3
給料	きゅうりょう	salary,wages	n3
絵画	かいが	picture, paintings	n3
絶対	ぜったい	absolute,unconditional,absoluteness	n3
絶滅	ぜつめつ	destruction,extinction	n3
続き	つづき	sequel,continuation	n3
維持	いじ	maintenance, preservation	n3
綿	めん	cotton,padding	n3
綿	わた	cotton,padding	n3
緊張	きんちょう	tension,mental strain,nervousness	n3
練習	れんしゅうする	practice, to practice	n3
縁	えん	relation, connection, ties, fate	n3
縁	ふち	an edge, a brim, a rim,	n3
縄	なわ	rope,hemp	n3
縦	たて	length,height	n3
繋ぐ	つなぐ	to tie,to fasten,to connect,to transfer (phone call)	n3
繰り返す	くりかえす	to repeat,to do something over again	n3
缶	かん	can,tin	n3
罪	つみ	crime,fault,indiscretion	n3
罰する	ばっする	to punish,to penalize	n3
署名	しょめい	signature	n3
罹る	かかる	to suffer from	n3
美人	びじん	beautiful person (woman)	n3
義務	ぎむ	duty,obligation,responsibility	n3
羽	はね	counter for birds,counter for rabbits	n3
翼	つばさ	wings	n3
老い	おい	old age, old person, the old, the aged	n3
老人	ろうじん	the aged,old person	n3
考え	かんがえ	thinking,thought,ideas,intention	n3
考慮	こうりょ	consideration,taking into account	n3
者	もの	person	n3
職	しょく	employment	n3
職業	しょくぎょう	occupation,business	n3
肌	はだ	skin	n3
肩	かた	shoulder	n3
育つ	そだつ	to raise (child),to be brought up,to grow (up)	n3
胃	い	stomach	n3
背	せい	height,stature	n3
胸	むね	breast,chest	n3
能	のう	ability, talent, a Noh play	n3
能力	のうりょく	ability,faculty	n3
脇	わき	side	n3
腐る	くさる	to rot,to go bad	n3
腰	こし	hip	n3
腹	はら	abdomen,belly,stomach	n3
膝	ひざ	knee,lap	n3
自動	じどう	automatic,self-motion	n3
自慢	じまん	pride,boast	n3
自殺	じさつ	suicide	n3
自然	しぜん	nature,spontaneous	n3
自身	じしん	by oneself,personally	n3
臭い	くさい	stink, smelly (bad)	n3
至る	いたる	to come, to arrive	n3
舌	した	tongue	n3
舞台	ぶたい	stage (theatre)	n3
航空	こうくう	aviation,flying	n3
船	ふね	ship,boat,watercraft,shipping,vessel,steamship	n3
芝居	しばい	play,drama	n3
芝生	しばふ	lawn	n3
芸術	げいじゅつ	(fine) art,the arts	n3
芽	め	sprout	n3
苦しい	くるしい	painful,difficult	n3
苦しむ	くるしむ	to suffer,to groan,to be worried	n3
苦労	くろう	troubles,hardships	n3
苦手	にがて	poor (at),weak (in),dislike (of)	n3
苦痛	くつう	pain,agony	n3
茶	ちゃ	tea	n3
莫大	ばくだい	enormous,vast	n3
菓子	かし	pastry	n3
著者	ちょしゃ	author,writer	n3
虎	とら	tiger	n3
虫歯	むしば	cavity,tooth decay,decayed tooth,caries	n3
行き	いき / ゆき	going,	n3
行儀	ぎょうぎ	manners	n3
行動	こうどう	action,conduct,behaviour,mobilization	n3
街	まち	(1) town, city	n3
衛星	えいせい	satellite	n3
衝突	しょうとつ	collision,conflict	n3
衣服	いふく	clothes	n3
表	ひょう	table (e.g. Tab 1),chart,list	n3
表す	あらわす	to express, to show, to reveal	n3
表情	ひょうじょう	facial expression	n3
表現	ひょうげん	expression,presentation,representation (math)	n3
表面	ひょうめん	surface,outside,face,appearance	n3
袋	ふくろ	bag,sack	n3
袖	そで	sleeve	n3
被る	かぶる	to put on , wear, cover (one's) head,	n3
被害	ひがい	damage	n3
裁判	さいばん	trial,judgement	n3
装置	そうち	equipment,installation,apparatus	n3
裏切る	うらぎる	to betray, to turn traitor to, to double-cross	n3
裸	はだか	naked,nude	n3
製品	せいひん	manufactured goods,finished goods	n3
製造	せいぞう	manufacture,production	n3
褒める	ほめる	to praise,to admire,to speak well	n3
要するに	ようするに	in a word,after all,the point is ..,in short ..	n3
要求	ようきゅう	request,demand,requisition	n3
要点	ようてん	gist,main point	n3
要素	ようそ	element	n3
覆う	おおう	to cover, to hide, to conceal, to wrap, to disguise	n3
見事	みごと	splendid,magnificent,beautiful,admirable	n3
見当	けんとう	be found,aim,estimate,guess,approx	n3
見舞い	みまい	enquiry,expression of sympathy,expression of concern	n3
見解	けんかい	opinion,point of view	n3
見送り	みおくり	seeing one off,farewell,escort	n3
覚ます	さます	to awaken	n3
覚める	さめる	to wake,to wake up	n3
覚悟	かくご	resolution, resignation, readiness, preparedness	n3
親しい	したしい	intimate,close (e.g. friend)	n3
親友	しんゆう	close friend,buddy	n3
親戚	しんせき	relative	n3
観光	かんこう	sightseeing	n3
観客	かんきゃく	audience,spectator(s)	n3
観察	かんさつ	observation,survey	n3
角	つの	horn	n3
解く	とく	to unfasten, to solve	n3
解ける	とける	to come untied,to come apart	n3
解決	かいけつ	settlement, solution, resolution	n3
解釈	かいしゃく	explanation, interpretation	n3
触れる	ふれる	to touch,to be touched,to touch on a subject,to feel,to violate (law, copyright, etc.),to perceive,t	n3
言う	ゆう	to say	n3
言わば	いわば	so to speak	n3
言語	げんご	language	n3
計る	はかる	to measure,to weigh,to survey	n3
計画	けいかくする	plan,project,schedule,scheme,program,to plan	n3
計算	けいさん	calculation,reckoning	n3
訓	くん	native Japanese reading of a Chinese character	n3
訓練	くんれん	practice,training	n3
記事	きじ	article,news story,report,account	n3
記入	きにゅう	entry,filling in of forms	n3
記念	きねん	commemoration,memory	n3
記憶	きおく	memory,recollection,remembrance	n3
記者	きしゃ	reporter	n3
記録	きろく	record,minutes,document	n3
訪問	ほうもん	call,visit	n3
設備	せつび	equipment,device,facilities,installation	n3
設計	せっけい	plan,design	n3
許す	ゆるす	to permit, to allow, to approve, to forgive	n3
訳	やく	translation, a version	n3
訴える	うったえる	to sue (a person),to resort to, to appeal to	n3
診察	しんさつ	medical examination	n3
証明	しょうめい	proof,verification	n3
評価	ひょうか	valuation,estimation,assessment,evaluation	n3
評判	ひょうばん	fame,reputation,popularity,arrant	n3
試し	ためし	trial,test	n3
試す	ためす	to attempt,to test	n3
詩	し	poem,verse of poetry	n3
詩人	しじん	poet	n3
詰める	つめる	to pack,to shorten,to work out (details)	n3
話し合う	はなしあう	to discuss,to talk together	n3
話題	わだい	topic,subject	n3
詳しい	くわしい	knowing very well,detailed,full,accurate	n3
誇り	ほこり	pride	n3
認める	みとめる	to recognize,to appreciate,to approve,to admit,to notice	n3
誕生	たんじょう	birth	n3
誘う	さそう	(1) to invite,to ask,(2) to tempt,to lure,to induce	n3
語	ご	suffix for language,word	n3
語る	かたる	to talk,to tell,to recite	n3
語学	ごがく	language study	n3
誤り	あやまり	error	n3
誤解	ごかい	misunderstanding	n3
説	せつ	theory	n3
読み	よみ	reading	n3
読書	どくしょ	reading	n3
誰か	だれか	someone,somebody	n3
課	か	counter for chapters (of a book) section	n3
調子	ちょうし	condition, form, shape, tune,tone,key	n3
調査	ちょうさ	investigation,examination,inquiry,survey	n3
請求	せいきゅう	claim,demand,application,request	n3
論じる	ろんじる	to argue,to discuss,to debate	n3
論争	ろんそう	controversy,dispute	n3
論文	ろんぶん	thesis,essay,treatise,paper	n3
諦める	あきらめる	to give up, to abandon	n3
諺	ことわざ	proverb,maxim	n3
謎	なぞ	riddle,puzzle,enigma	n3
講演	こうえん	lecture,address	n3
警告	けいこく	warning,advice	n3
議会	ぎかい	Diet,congress,parliament	n3
議員	ぎいん	member of the Diet, congress or parliament	n3
議論	ぎろん	argument,discussion,dispute	n3
議長	ぎちょう	chairman	n3
譲る	ゆずる	to turn over,to assign,to hand over	n3
谷	たに	valley	n3
豆	まめ	beans,peas	n3
豊か	ゆたか	abundant,wealthy,plentiful,rich	n3
豊富	ほうふ	abundance,wealth,plenty,bounty	n3
象	ぞう	elephant	n3
豪華	ごうか	wonderful,gorgeous,splendor,pomp,extravagance	n3
負け	まけ	defeat,loss,losing (a game)	n3
財産	ざいさん	property,fortune,assets	n3
貢献	こうけん	contribution,services	n3
貧しい	まずしい	poor, needy	n3
販売	はんばい	sale,selling,marketing	n3
責める	せめる	to condemn,to blame,to criticize	n3
責任	せきにん	duty,responsibility	n3
貯金	ちょきん	(bank) savings	n3
貰う	もらう	to receive	n3
貴重	きちょう	precious,valuable	n3
費用	ひよう	cost,expense	n3
資本	しほん	funds,capital	n3
資源	しげん	resources	n3
賛成	さんせい	approval,agreement,support,favour	n3
賞	しょう	prize,award	n3
賢い	かしこい	wise,clever,smart	n3
質	しつ	quality,nature (of person)	n3
贅沢	ぜいたく	luxury,extravagance	n3
贈る	おくる	to send, to give to, to award to, to confer on	n3
起こる	おこる	to occur, to happen	n3
越える	こえる	to exceed,to cross over,to cross	n3
越す	こす	to go over (e.g. with audience)	n3
跡	あと	(1) trace, tracks, mark, sign, (2) remains, ruins, (3) scar	n3
身	み	body,main part,oneself,sword	n3
身体	しんたい	the body	n3
身長	しんちょう	height (of body),stature	n3
軍	ぐん	army,force,troops	n3
軍隊	ぐんたい	army,troops	n3
軒	けん	a couter for house	n3
軒	のき	eaves	n3
転ぶ	ころぶ	to fall down,to fall over	n3
輝く	かがやく	to shine, to glitter, to sparkle	n3
輪	わ	ring,hoop,circle	n3
輸入	ゆにゅうする	importation,import,introduction, to import	n3
輸出	ゆしゅつする	export, to export	n3
轢く	ひく	to run somebody over (with vehicle),to knock someone down	n3
辛い	つらい	painful,heart-breaking	n3
辞める	やめる	to retire	n3
農家	のうか	farmer,farm family	n3
農業	のうぎょう	agriculture	n3
農民	のうみん	farmers,peasants	n3
辺り	あたり	vicinity, nearby	n3
迎え	むかえ	meeting,person sent to pick up an arrival	n3
近代	きんだい	modern ages	n3
近頃	ちかごろ	lately,recently,nowadays	n3
述べる	のべる	to state,to express,to mention	n3
迷子	まいご	lost (stray) child	n3
迷惑	めいわく	trouble,bother,annoyance	n3
追い付く	おいつく	to overtake, to catch up (with)	n3
追う	おう	to chase, to run after	n3
退屈	たいくつ	tedium,boredom	n3
逆	ぎゃく	reverse,opposite	n3
逆らう	さからう	to go against,to oppose,to disobey,to defy	n3
途端	とたん	just (now, at the moment, etc.)	n3
通じる	つうじる	to run to,to lead to,to communicate,to understand	n3
通す	とおす	to let pass,to overlook,to continue	n3
通り	とおり	in accordance with ~,following ~,~ Street,~ Avenue	n3
通り過ぎる	とおりすぎる	to pass,to pass through	n3
通信	つうしん	correspondence,communication,news,signal	n3
通学	つうがく	commuting to school	n3
通行	つうこう	passage,passing	n3
通過	つうか	passage through,passing	n3
速度	そくど	speed,velocity,rate	n3
連れ	つれ	companion,company	n3
連想	れんそう	association (of ideas),suggestion	n3
連続	れんぞく	serial,consecutive,continuity,continuing	n3
逮捕	たいほ	arrest,apprehension,capture	n3
週	しゅう	week	n3
週間	しゅうかん	week,weekly	n3
進める	すすめる	to advance,to promote,to hasten	n3
進学	しんがく	going on to a higher level school,	n3
進歩	しんぽ	progress,development	n3
遂に	ついに	finally,at last	n3
遅刻	ちこく	lateness,late coming	n3
運	うん	fortune, luck	n3
運動	うんどうする	motion, exercise, to exercise	n3
運転	うんてんする	operation, motion, driving, to drive	n3
過ごす	すごす	to pass,to spend,to go through,to tide over	n3
過去	かこ	the past,bygone days,the previous	n3
道徳	どうとく	morals	n3
道路	どうろ	road,highway	n3
達する	たっする	to reach,to get to	n3
違い	ちがい	difference,discrepancy	n3
違いない	ちがいない	(phrase) sure,no mistaking it,for certain	n3
違反	いはん	violation (of law),transgression, infringement, breach	n3
遠慮	えんりょ	diffidence, restraint, reserve	n3
適する	てきする	to fit,to suit	n3
適切	てきせつ	pertinent,appropriate,adequate,relevance	n3
適度	てきど	moderate	n3
適用	てきよう	applying	n3
選手	せんしゅ	(1) player (in game),(2) team	n3
選択	せんたく	selection,choice	n3
避ける	さける	(1) to avoid (physical contact ),(2) to ward off,to avert	n3
邪魔	じゃま	hindrance,intrusion	n3
部分	ぶぶん	portion,section,part	n3
郵便	ゆうびん	mail,postal service	n3
都	みやこ	capital	n3
都会	とかい	city	n3
都市	とし	town,city,municipal,urban	n3
配達	はいたつ	delivery,distribution	n3
酒	さけ	alcohol,sake	n3
酔う	よう	to get drunk,to become intoxicated	n3
酸素	さんそ	oxygen	n3
重大	じゅうだい	serious,important,grave,weighty	n3
重要	じゅうよう	important, momentous, essential, principal, major	n3
重視	じゅうし	importance,stress,serious consideration	n3
野	の	field	n3
量	りょう	quantity,amount,volume,portion (of food)	n3
金	かね	(1) gold,(2) gold general (shogi) (abbr)	n3
金	きん	(1) gold,(2) gold general (shogi) (abbr)	n3
金属	きんぞく	metal	n3
金庫	きんこ	safe,vault,treasury,provider of funds	n3
金曜	きんよう	(abbr) Friday	n3
金融	きんゆう	finance, monetary circulation,	n3
金銭	きんせん	money,cash	n3
金額	きんがく	amount of money	n3
針	はり	needle,hand (e.g. clock)	n3
釣	つり	fishing	n3
鉄	てつ	iron	n3
鉄道	てつどう	railroad	n3
銀	ぎん	(1) silver,silver coin,silver paint	n3
銃	じゅう	gun	n3
銅貨	どうか	copper coin	n3
鋭い	するどい	pointed,sharp	n3
鍋	なべ	saucepan,pot	n3
鍵	かぎ	key	n3
鎖	くさり	chain	n3
長期	ちょうき	long time period	n3
閉じる	とじる	to close (e.g. book, eyes),to shut	n3
開始	かいし	start, commencement, beginning	n3
間	ま	space,room,time,pause	n3
間違い	まちがい	mistake	n3
関する	かんする	to concern,to be related	n3
関心	かんしん	concern,interest	n3
関連	かんれん	relation,connection,relevance	n3
防ぐ	ふせぐ	to defend (against),to protect,to prevent	n3
降ろす	おろす	to take down, to launch, to drop	n3
限る	かぎる	to restrict,to limit,to confine	n3
限界	げんかい	limit,bound	n3
除く	のぞく	to remove,to exclude,to except	n3
陰	かげ	shade,shadow,other side	n3
陸	りく	(the) land	n3
陽気な	ようき	cheerful, lively, merry	n3
随分	ずいぶん	extremely	n3
際	さい	on the occasion of,circumstances	n3
障害	しょうがい	obstacle,impediment (fault),damage	n3
隠す	かくす	to hide,to conceal	n3
隠れる	かくれる	to hide, to be hidden, to conceal oneself, to disappear	n3
集まり	あつまり	gathering, meeting, assembly, collection	n3
集中	しゅうちゅう	concentration,focusing the mind	n3
集団	しゅうだん	group,mass	n3
雇う	やとう	to employ,to hire	n3
離す	はなす	to part,divide,separate	n3
離れる	はなれる	to be separated from,to leave,to go away,to be a long way off	n3
離婚	りこん	divorce	n3
雰囲気	ふんいき	atmosphere (e.g. musical),mood,ambience	n3
雷	かみなり	thunder	n3
電子	でんし	electron	n3
需要	じゅよう	demand,request	n3
震える	ふるえる	to shiver,to shake,to quake	n3
霜	しも	frost	n3
霧	きり	fog,mist	n3
青年	せいねん	youth,young man	n3
非常	ひじょう	emergency,extraordinary,unusual	n3
面	めん	a mask, the face, the surface, an aspect, a side,	n3
面倒	めんどう	trouble,difficulty,care,attention	n3
革	かわ	leather	n3
音	おん	sound, note	n3
頂く	いただく	to receive, to take food or drink (hum)	n3
頂上	ちょうじょう	top,summit,peak	n3
頃	ころ	time,about,toward,approximately (time)	n3
順	じゅん	order,turn	n3
順番	じゅんばん	turn (in line),order of things	n3
順調	じゅんちょう	favourable,doing well,O.K.,all right	n3
預ける	あずける	to give into custody, to entrust, to deposit	n3
頬	ほお	cheek (of face)	n3
頬	ほほ	cheek (of face)	n3
頭痛	ずつう	headache	n3
頼る	たよる	to rely on,to have recourse to,to depend on	n3
題	だい	title,subject,theme,topic	n3
額	がく	picture frame	n3
額	ひたい	forehead,brow	n3
願い	ねがい	desire,wish,request	n3
願う	ねがう	to desire,to wish,to request	n3
風呂	ふろ	bath	n3
風景	ふうけい	scenery	n3
飛ばす	とばす	to skip over,to omit	n3
飛び出す	とびだす	to jump out,to rush out,to fly out	n3
飛行	ひこう	aviation	n3
食う	くう	(male) (vulg) to eat	n3
食事	しょくじする	meal, to have a meal	n3
食卓	しょくたく	dining table	n3
食品	しょくひん	commodity,foodstuff	n3
食料	しょくりょう	food	n3
食欲	しょくよく	appetite (for food)	n3
食物	しょくもつ	food,foodstuff	n3
食糧	しょくりょう	provisions,rations	n3
飯	めし	(sl) meals,food	n3
飼う	かう	to keep, to raise, to feed	n3
飽きる	あきる	to get tired of, to lose interest in, to have enough	n3
餌	えさ	feed, bait	n3
首相	しゅしょう	Prime Minister	n3
首都	しゅと	capital city	n3
香り	かおり	aroma, fragrance, scent, smell	n3
馬	うま	(1) horse,(2) promoted bishop (shogi)	n3
馬鹿	ばか	fool,idiot,trivial matter,folly	n3
駄目	だめ	useless,no good,hopeless	n3
駐車	ちゅうしゃ	parking (e.g. car)	n3
騒ぎ	さわぎ	uproar,disturbance	n3
騒音	そうおん	noise	n3
骨	ほね	bone	n3
骨折	こっせつ	bone fracture	n3
高価	こうか	high price	n3
高速	こうそく	high speed,high gear	n3
髪の毛	かみのけ	hair (head)	n3
鬼	おに	ogre, demon, it (i.e., in a game of tag)	n3
魅力	みりょく	charm,fascination,glamour	n3
魚	うお	fish	n3
黒板	こくばん	blackboard	n3
黙る	だまる	to be silent	n3
鼠	ねずみ	(1) mouse, rat,	n3
